[
  {
    "Stage": 1,
    "Map": [
      [ 0, 0, 1, 1, 1, 0, 0, 0 ],
      [ 0, 0, 1, 2, 1, 0, 0, 0 ],
      [ 0, 0, 1, 0, 1, 1, 1, 1 ],
      [ 1, 1, 1, 3, 0, 3, 2, 1 ],
      [ 1, 2, 0, 3, 4, 1, 1, 1 ],
      [ 1, 1, 1, 1, 3, 1, 0, 0 ],
      [ 0, 0, 0, 1, 2, 1, 0, 0 ],
      [ 0, 0, 0, 1, 1, 1, 0, 0 ]
    ]
  },
  {
    "Stage": 2,
    "Map": [
      [ 0, 1, 1, 1, 1, 1, 1, 1, 0 ],
      [ 0, 1, 0, 4, 2, 2, 2, 1, 0 ],
      [ 0, 1, 0, 0, 0, 1, 1, 1, 1 ],
      [ 1, 1, 1, 3, 0, 0, 0, 0, 1 ],
      [ 1, 0, 0, 0, 1, 3, 1, 0, 1 ],
      [ 1, 0, 3, 0, 1, 0, 0, 0, 1 ],
      [ 1, 0, 0, 0, 1, 1, 1, 1, 1 ],
      [ 1, 1, 1, 1, 1, 0, 0, 0, 0 ]
    ]
  },
 {
    "Stage": 3,
    "Map": [
      [0, 0, 0, 0, 0, 0, 0, 0, 0, 0, 0, 0, 1, 1, 1, 1, 0, 0],
      [0, 0, 0, 0, 0, 0, 0, 0, 0, 0, 1, 1, 1, 0, 0, 1, 1, 1],
      [0, 0, 0, 0, 0, 0, 0, 0, 0, 1, 1, 2, 3, 2, 0, 0, 0, 1],
      [0, 0, 0, 0, 0, 0, 0, 0, 1, 1, 2, 3, 2, 3, 3, 2, 0, 1],
      [0, 0, 0, 0, 0, 0, 0, 1, 1, 2, 3, 2, 3, 3, 2, 3, 1, 1],
      [0, 0, 0,	0, 0, 0, 1, 1, 2, 3, 2, 3, 3, 2, 3, 2, 1, 0],
      [0, 0, 0, 0, 0, 1, 1, 2, 3, 2, 3, 3, 2, 3, 2, 1, 1, 0],
      [0, 0, 0, 0, 1, 1, 2, 3, 2, 3, 3, 2, 3, 2, 1, 1, 0, 0],
      [0, 0, 0, 1, 1, 2, 3, 2, 3, 3, 2, 3, 2, 1, 1, 0, 0, 0],
      [0, 0, 1, 1, 2, 3, 2, 3, 3, 2, 3, 2, 1, 1, 0, 0, 0, 0],
      [0, 1, 1, 2, 3, 2, 3, 3, 2, 3, 2, 1, 1, 0, 0, 0, 0, 0],
      [1, 1, 2, 3, 2, 3, 3, 2, 3, 2, 1, 1, 0, 0, 0, 0, 0, 0],
      [1, 2, 3, 2, 3, 3, 2, 3, 2, 1, 1, 0, 0, 0, 0, 0, 0, 0],
      [1, 1, 0, 3, 3, 2, 3, 2, 1, 1, 0, 0, 0, 0, 0, 0, 0, 0],
      [0, 1, 4, 0, 0, 3, 2, 1, 1, 0, 0, 0, 0, 0, 0, 0, 0, 0],
      [0, 1, 1, 1, 1, 2, 1, 1, 0, 0, 0, 0, 0, 0, 0, 0, 0, 0],
      [0, 0, 0, 0, 1, 1, 1, 0, 0, 0, 0, 0, 0, 0, 0, 0, 0, 0],
      ]
  },
  {
    "Stage": 4,
    "Map": [
      [ 0, 1, 1, 1, 1, 1, 1, 1, 1, 1, 0 ],
      [ 0, 1, 0, 0, 1, 1, 0, 0, 0, 1, 0 ],
      [ 0, 1, 0, 0, 0, 3, 0, 0, 0, 1, 0 ],
      [ 0, 1, 3, 0, 1, 1, 1, 0, 3, 1, 0 ],
      [ 0, 1, 0, 1, 2, 2, 2, 1, 0, 1, 0 ],
      [ 1, 1, 0, 1, 2, 2, 2, 1, 0, 1, 1 ],
      [ 1, 0, 3, 0, 0, 3, 0, 0, 3, 0, 1 ],
      [ 1, 0, 0, 0, 0, 0, 1, 0, 4, 0, 1 ],
      [ 1, 1, 1, 1, 1, 1, 1, 1, 1, 1, 1 ]
    ]
  },
  {
    "Stage": 5,
    "Map": [
      [ 0, 0, 0, 1, 1, 1, 1, 1, 0 ],
      [ 1, 1, 1, 1, 0, 0, 0, 1, 0 ],
      [ 1, 0, 3, 0, 0, 1, 3, 1, 0 ],
      [ 1, 0, 1, 0, 2, 0, 0, 1, 1 ],
      [ 1, 0, 0, 2, 1, 2, 0, 0, 1 ],
      [ 1, 1, 0, 0, 0, 0, 1, 0, 1 ],
      [ 0, 1, 0, 1, 0, 0, 3, 0, 1 ],
      [ 0, 1, 4, 0, 0, 1, 1, 1, 1 ],
      [ 0, 1, 1, 1, 1, 1, 0, 0, 0 ]
    ]
  },
  {
    "Stage": 6,
    "Map": [
      [ 1, 1, 1, 1, 1, 1, 1, 1, 1, 1, 1, 1, 1, 1, 1, 1, 1, 1, 1 ],
      [ 1, 1, 1, 1, 1, 0, 0, 0, 1, 1, 1, 1, 1, 1, 1, 1, 1, 1, 1 ],
      [ 1, 1, 1, 1, 1, 3, 0, 0, 1, 1, 1, 1, 1, 1, 1, 1, 1, 1, 1 ],
      [ 1, 1, 1, 1, 1, 0, 0, 3, 1, 1, 1, 1, 1, 1, 1, 1, 1, 1, 1 ],
      [ 1, 1, 1, 0, 0, 3, 0, 3, 0, 1, 1, 1, 1, 1, 1, 1, 1, 1, 1 ],
      [ 1, 1, 1, 0, 1, 0, 1, 1, 0, 1, 1, 1, 1, 1, 1, 1, 1, 1, 1 ],
      [ 1, 0, 0, 0, 1, 0, 1, 1, 0, 1, 1, 1, 1, 1, 0, 0, 2, 2, 1 ],
      [ 1, 0, 3, 0, 0, 3, 0, 0, 0, 4, 0, 0, 0, 0, 0, 0, 2, 2, 1 ],
      [ 1, 1, 1, 1, 1, 0, 1, 1, 1, 0, 1, 0, 1, 1, 0, 0, 2, 2, 1 ],
      [ 1, 1, 1, 1, 1, 0, 0, 0, 0, 0, 1, 1, 1, 1, 1, 1, 1, 1, 1 ],
      [ 1, 1, 1, 1, 1, 1, 1, 1, 1, 1, 1, 1, 1, 1, 1, 1, 1, 1, 1 ]
    ]
  },
  {
    "Stage": 7,
    "Map": [
      [ 1, 1, 1, 1, 1, 1, 1, 1 ],
      [ 1, 0, 0, 1, 2, 0, 0, 1 ],
      [ 1, 0, 0, 3, 0, 0, 0, 1 ],
      [ 1, 0, 0, 0, 0, 2, 1, 1 ],
      [ 1, 1, 3, 0, 0, 3, 0, 1 ],
      [ 1, 2, 0, 0, 0, 0, 0, 1 ],
      [ 1, 0, 0, 4, 0, 0, 0, 1 ],
      [ 1, 1, 1, 1, 1, 1, 1, 1 ],   
    ]
  },
  {
    "Stage": 8,
    "Map": [
      [ 1, 1, 1, 1, 1, 1, 1, 1 ],
      [ 1, 0, 0, 0, 0, 2, 0, 1 ],
      [ 1, 0, 0, 3, 2, 0, 0, 1 ],
      [ 1, 0, 1, 1, 3, 0, 1, 1 ],
      [ 1, 0, 1, 1, 0, 0, 1, 0 ],
      [ 1, 0, 1, 1, 0, 0, 1, 0 ],
      [ 1, 4, 1, 1, 0, 0, 1, 0 ],
      [ 1, 1, 1, 1, 1, 1, 1, 0 ],   
    ] 
  },
  {
    "Stage": 9,
    "Map": [
      [0, 0, 0, 0, 0, 0, 0, 0, 0, 0, 0, 0, 0, 0, 0, 0, 0, 0],
      [0, 0, 0, 0, 0, 0, 0, 0, 0, 0, 0, 0, 0, 1, 1, 1, 0, 0],
      [0, 0, 0, 0, 0, 0, 0, 0, 0, 0, 0, 0, 1, 1, 2, 1, 0, 0],
      [0, 0, 0, 0, 0, 0, 0, 0, 0, 0, 0, 1, 1, 2, 3, 1, 1, 0],
      [0, 0, 0, 0, 0, 0, 0, 0, 0, 0, 1, 1, 2, 3, 3, 2, 1, 0],
      [0, 0, 0, 0, 0, 0, 0, 0, 0, 1, 1, 2, 3, 3, 2, 1, 1, 0],
      [0, 0, 0, 0, 0, 0, 0, 0, 1, 1, 2, 3, 3, 2, 1, 1, 0, 0],
      [0, 0, 0, 0, 0, 0, 0, 1, 1, 2, 3, 3, 2, 1, 1, 0, 0, 0],
      [0, 0, 0, 0, 0, 0, 1, 1, 2, 3, 3, 2, 1, 1, 0, 0, 0, 0],
      [0, 0, 0, 0, 0, 1, 1, 2, 3, 3, 2, 1, 1, 0, 0, 0, 0, 0],
      [0, 0, 0, 0, 1, 1, 2, 3, 3, 2, 1, 1, 0, 0, 0, 0, 0, 0],
      [0, 0, 0, 1, 1, 2, 3, 3, 2, 1, 1, 0, 0, 0, 0, 0, 0, 0],
      [0, 0, 1, 1, 2, 3, 3, 2, 1, 1, 0, 0, 0, 0, 0, 0, 0, 0],
      [0, 0, 1, 2, 3, 3, 2, 1, 1, 0, 0, 0, 0, 0, 0, 0, 0, 0],
      [0, 0, 1, 3, 3, 2, 1, 1, 0, 0, 0, 0, 0, 0, 0, 0, 0, 0],
      [0, 0, 1, 4, 1, 1, 1, 0, 0, 0, 0, 0, 0, 0, 0, 0, 0, 0],
      [0, 0, 1, 1, 1, 0, 0, 0, 0, 0, 0, 0, 0, 0, 0, 0, 0, 0]
    ] 
  },
  {
    "Stage": 10,
    "Map": [
      [ 0, 0, 0, 1, 1, 1, 1, 0, 0 ],
      [ 0, 0, 1, 1, 0, 0, 1, 0, 0 ],
      [ 1, 1, 1, 0, 0, 0, 1, 1, 0 ],
      [ 1, 0, 0, 3, 2, 3, 0, 1, 1 ],
      [ 1, 0, 0, 2, 1, 2, 0, 0, 1 ],
      [ 1, 1, 1, 3, 2, 3, 0, 0, 1 ],
      [ 0, 0, 1, 0, 4, 0, 1, 1, 1 ],
      [ 0, 0, 1, 0, 0, 1, 1, 0, 0 ],
      [ 0, 0, 1, 1, 1, 1, 0, 0, 0 ],
    ] 
}
]